1111111111111111110000000000000000000000000000000000000001
1000000000000000000000000000000000010000000000000000000001
1000000000000000000000000000000000010000000000000000000001
1000000000000000000000000000000000010000000000000000000001
1000000000000000000000000000000000010000000000000000000001
1111111111111111110000000000000000000000000000000000000001
1000000000000000000000000000000000010000000000000000000001
1000000000000000000000000000000000010000000000000000000001
1000000000000000000000000000000000010000000000000000000001
1000000000000000000000000000000000010000000000000000000001
1000000000000000000000000000000000000000000000000000000001
1111111111111111110000000000000000000000000000000000000001
1000000000000000000000000000000000010000000000000000000001
1000000000000000000000000000000000010000000000000000000001
1000000000000000000000000000000000010000000002000000000001
1000000000000000000000000000000000010000000000000000000001
1000000000003000000000000000000000000000000000000000000001
1111111111111111110000000000000000000000000000000000000001
1000000000000000000000000000000000010000000000000000000001
1000000000000000000000000000000000010000000000000000000001
1000000000000000000000000000000000010000000000000000000001
1000000000000000000000000000000000010000000000000000000001
0000001000000000000000000000000000010000000000000000000000
0000001000000000003000000000000000010000000000000000000000
1000001000000000000000000000000000010000000000000000000001
1000001000000000000000000000000000010000000000000000000001
1000001000000000000000000000000000010000000000000000000001
1111001000000000000000000000000000010000000000000000000001
1000000000000000000000000000000000010000000000000000000001
1000000000000000000000000000000000010000000000000000000001
1000000000000000000000000000000000000000000000000000000001
1000000000000000000000000000000000000000000000000000000001
1000000000000000000000000000000000000000000000000000000001
1000000000000000000000000000000000000000000000000000000001
1000000000000000000000000000000000000000000000000000000001
1000000000000000000000000000000000000000000000000000000001
1000000000000000000000000000000000000000000000000000000001
1000000000000000000000000000000000000000000000000000000001
1000000000000000000000000000000000000000000000000000000001
1111111111111111110000000000000000000000000000000000000001

0 blank
1 wall
2 head - only one
3 1st apple - only one

