1111111111111111110000001111111111111111111111111111111111
1000000000000000000000000000000000010000000000000000000001
1000000000000000000000000000000000010000000000000000000001
1000000000000000000000000000000000010000000000000000000001
1000000000000000000000000000000000010000000000000000000001
1000000000000000000000000000000000010000000000000000000001
1000000000000000000000000000000000010000000000000000000001
1111000000000000000000000000000000010000000000000000000001
1000000000000000000000000000000000010000000003000000000001
1000000000000000000000000000000000010000000000000000000001
1000000000000000000000000000000000000000000000000000000001
1000000000000000000000000000000000000000000000000000000001
1000000000000000000000000000000000000000000000000000000001
1000000000000000000000000000000000000000000000000000000001
1000000000000000000000000000000000000000000000000000000001
1000000000000000000000000000000000000000000000000000000001
1000000000000000000000000000000000000000000000000000000001
1000000000000000000000000000000000000000000000000000000001
1000000000000000000000000000000000000000000000000000000001
1000000000000000000000000000000000000000000000000000000001
0000000000000000000000000000000000000000000000000000000000
1111111111111111110000001111111111111111111111111111111111
0000001000000000000000000000000000010000000000000000000000
0000001000000000000000000000000000010000000000000000000000
1000001000000000000000000000000000010000000000000000000001
1000001000000000000000020000000000010000000000000000000001
1000001000000000000000000000000000010000000000000000000001
1111001000000000000000000000000000010000000000000000000001
1000000000000000000000000000000000010000000000000000000001
1000000000000000000000000000000000010000000000000000000001
1000000000000000000000000000000000000000000000000000000001
1000000000000000000000000000000000000000000000000000000001
1000000000000000000000000000000000000000000000000000000001
1000000000000000000000000000000000000000000000000000000001
1000000000000000000000000000000000000000000000000000000001
1000000000000000000000000000000000000000000000000000000001
1000000000000000000000000000000000000000000000000000000001
1000000000000000000000000000000000000000000000000000000001
1000000000000000000000000000000000000000000000000000000001
1111111111111111110000001111111111111111111111111111111111


0 blank
1 wall
2 head - only one
3 1st apple - only one

