1111111111111111111111111111111111111111111111111111111111
1000001000000000000000000000000000010000000000000000000001
1000001000000000000000000000000000010000000000000000000001
1000001000000000000000000000000000010000000000000000000001
1000001000000000000000000000000000010000000000000000000001
1000001000000000000000000000000000010000000000000000000001
1000001000000000000000000000000000010000000000000000000001
1111001000000000000000000000000000010000000000000000000001
1000000000000000000000000000000000010000000000000000000001
1000000000000000000000000000000000010000000000000000000001
1000000000000000000000000000000000000000000000000000000001
1000000000000000000000000000000000000000000000000000000001
1000000000000000000000000000000000000000000000000000000001
1000000000000000000000000000000000000000000000000000000001
1000000000000000000000000000000000000000000000000000000001
1000000000000000000000000000000000000000000000000000000001
1000000000000000000000000000000000000000000000000000000001
1000000000000000000000000000000000000000000000000000000001
1000000000000000000000000000000000000000000000000000000001
1000000000000000000000000000000000000000000000000000000001
1000000000000000000000000000000000000000000000000000000001
1000001000000000000000000000000000000000000000000000000001
1000001000000002000000000000000000010000000000000000000001
1000001000000000000000000000000000010000000000000000000001
1000001000000000000000000000000000010000000000000000000001
1000001000000000000000000000000000010000000000000000000001
1000001000000000000000000000000000010000000000000000000001
1111001000000000000000000000000000010000000000000000000001
1000000000000000000000000000000000010000000000000000000001
1000000000000000000000000000000000010000000000000000000001
1000000000000000000000000000000000000000000000000000000001
1000000000000000000000000000000000000000000000000000000001
1000000000000000000000000000000000000000000000000000000001
1000000000000000000000000000000000000000000000000000000001
1000000000000000000000000000000000000000000000000000000001
1000000000000000000000000000000000000000000000000000000001
1000000000000000000000000000000000000000000000000000000001
1000000000000000000000000000000000000000000000000000000001
1000000000000000000000000000000000000000000000000000000001
1111111111111111111111111111111111111111111111111111111111


0 blank
1 wall
2 head - only one

